...........
....xxx....
...x...x...
..x.....x..
...........

