..........
..........
..........
....x.....
...xxx....
..xxxxx...
..........
..........
..........
..........
..........
..........
..xxxxx...
...xxx....
....x.....
..........
..........
